//MAP CONVERTED BY dmm2tgm.py THIS HEADER COMMENT PREVENTS RECONVERSION, DO NOT REMOVE
"a" = (
/turf/closed/wall/mineral/titanium,
/area/shuttle/arrival)
"c" = (
/obj/structure/shuttle/engine/propulsion/burst/right{
	dir = 4
	},
/turf/open/floor/plating/airless,
/area/shuttle/arrival)
"d" = (
/obj/machinery/light{
	dir = 1
	},
/obj/structure/closet/emcloset,
/turf/open/floor/mineral/titanium,
/area/shuttle/arrival)
"h" = (
/obj/machinery/light,
/obj/structure/closet/wardrobe/black,
/turf/open/floor/mineral/titanium,
/area/shuttle/arrival)
"j" = (
/obj/machinery/light{
	dir = 1
	},
/turf/open/floor/mineral/titanium,
/area/shuttle/arrival)
"k" = (
/obj/docking_port/mobile/arrivals,
/obj/machinery/door/airlock/titanium{
	name = "Arrivals Shuttle Airlock"
	},
/turf/open/floor/mineral/titanium,
/area/shuttle/arrival)
"m" = (
/turf/open/floor/mineral/titanium,
/area/shuttle/arrival)
"q" = (
/obj/machinery/light,
/turf/open/floor/mineral/titanium,
/area/shuttle/arrival)
"r" = (
/obj/structure/chair/comfy/shuttle{
	dir = 4
	},
/turf/open/floor/mineral/titanium,
/area/shuttle/arrival)
"s" = (
/obj/structure/shuttle/engine/heater{
	dir = 4
	},
/obj/structure/window/reinforced{
	dir = 8
	},
/turf/open/floor/plating/airless,
/area/shuttle/arrival)
"y" = (
/obj/machinery/light/small{
	dir = 1
	},
/turf/open/floor/mineral/titanium,
/area/shuttle/arrival)
"I" = (
/obj/structure/chair/comfy/shuttle,
/turf/open/floor/mineral/titanium,
/area/shuttle/arrival)
"K" = (
/obj/effect/spawner/structure/window/shuttle,
/turf/open/floor/plating/airless,
/area/shuttle/arrival)
"T" = (
/obj/structure/chair/comfy/shuttle{
	dir = 1
	},
/turf/open/floor/mineral/titanium,
/area/shuttle/arrival)
"U" = (
/obj/machinery/door/airlock/titanium{
	name = "Arrivals Shuttle Airlock"
	},
/turf/open/floor/mineral/titanium,
/area/shuttle/arrival)
"W" = (
/turf/closed/wall/mineral/titanium/nodiagonal,
/area/shuttle/arrival)

(1,1,1) = {"
a
K
K
K
a
"}
(2,1,1) = {"
W
r
r
r
W
"}
(3,1,1) = {"
W
j
m
q
W
"}
(4,1,1) = {"
K
I
m
T
K
"}
(5,1,1) = {"
K
I
m
T
K
"}
(6,1,1) = {"
K
I
m
T
K
"}
(7,1,1) = {"
W
d
m
h
W
"}
(8,1,1) = {"
W
W
U
W
W
"}
(9,1,1) = {"
s
W
y
W
s
"}
(10,1,1) = {"
c
W
k
W
c
"}
